NO ./mandatory/textures/NORTH.png
SO ./mandatory/textures/SOUTH.png
WE ./mandatory/textures/WEST.png
EA ./mandatory/textures/EAST.png

F 220,100,0
C 225,30,0

1111111111111111111
1111111100000000011
111111100000000000111111
1111110000010010000000011
11111000001111000000100011
111100000111100000000100011
111000000111110000001000001
110000000111111000010000011
11100000111111110010000001
11110001111111111111100011

