NO ./mandatory/textures/NORTH.png
SO ./mandatory/textures/SOUTH.png
WE ./mandatory/textures/WEST.png
EA ./mandatory/textures/EAST.png

F 220,100,0
C 225,30,0

1111111111111111111111
11111111110000000000011
111111110000000000000011
1111111000000000000000011111
11111100000011111110000000011
111110000011111111000000100011
1111000001111111100000000100011
1110000001111111110000001000001
1100000001111111111000010000011
110000001111111111110010000001
1110000111111111111111110N0111
111111111111111111111111111111
